32040,196,6279776,6279840,64,1.01913E-05,0.001019134
32018,156,4995604,4994808,796,0.000159365,0.015936549
32083,71,2277561,2277893,332,0.000145749,0.014574872
32133,164,5267844,5269812,1968,0.000373448,0.037344786
32115,75,2408625,2408625,0,0,0
32054,26,832589,833404,815,0.000977917,0.097791707
32025,34,1089275,1088850,425,0.00039032,0.039032006
32005,65,2080325,2080325,0,0,0
32062,16,512992,512992,0,0,0
32156,137,4398504,4405372,6868,0.001559006,0.155900569
32075,141,4527375,4522575,4800,0.001061342,0.106134227
32016,19,608303,608304,1,1.64391E-06,0.000164391
32054,136,4362948,4359344,3604,0.00082673,0.082672989
32029,20,640580,640580,0,0,0
32113,48,1541424,1541424,0,0,0
32106,161,5170682,5169066,1616,0.000312629,0.031262901
32113,21,674373,674373,0,0,0
32186,175,5632469,5632550,81,1.43807E-05,0.00143807
32024,8,256284,256192,92,0.000359106,0.035910567
32128,65,2088320,2088320,0,0,0
32174,46,1479905,1480004,99,6.68917E-05,0.006689171
32010,29,928126,928290,164,0.000176669,0.017666893
32021,141,4516305,4514961,1344,0.000297677,0.029767699
32158,104,3350292,3344432,5860,0.001752166,0.175216599
32025,159,5093175,5091975,1200,0.000235665,0.023566494
32042,150,4808797,4806300,2497,0.000519526,0.051952645
32160,164,5272624,5274240,1616,0.000306395,0.030639485
32174,145,4659918,4665230,5312,0.001138636,0.113863625
32041,68,2178788,2178788,0,0,0
32040,97,3105944,3107880,1936,0.000622933,0.062293267
32069,162,5196351,5195178,1173,0.000225786,0.02257863
32009,188,6017692,6017692,0,0,0
32164,139,4464839,4470796,5957,0.001332425,0.133242492
32122,153,4920942,4914666,6276,0.001276994,0.12769942
32194,6,193349,193164,185,0.000957735,0.09577354
32147,171,5497137,5497137,0,0,0
32011,67,2144737,2144737,0,0,0
32187,26,837897,836862,1035,0.001236763,0.123676305
32091,111,3556277,3562101,5824,0.00163499,0.163499014
32198,196,6310744,6310808,64,1.01413E-05,0.001014133
32116,27,865271,867132,1861,0.002146155,0.214615537
32162,61,1961878,1961882,4,2.03886E-06,0.000203886
32159,67,2154653,2154653,0,0,0
32164,119,3833755,3827516,6239,0.001630039,0.163003891
32053,136,4362812,4359208,3604,0.000826756,0.082675569
32166,131,4207921,4213746,5825,0.00138238,0.138238043
32139,61,1960479,1960479,0,0,0
32003,173,5536519,5536519,0,0,0
32001,44,1408044,1408044,0,0,0
32084,29,929088,930436,1348,0.001448783,0.144878315
32156,87,2797971,2797572,399,0.000142624,0.014262368
32086,164,5263400,5262104,1296,0.000246289,0.024628932
32199,189,6085611,6085611,0,0,0
32025,163,5220475,5220075,400,7.66273E-05,0.007662725
32035,51,1633785,1633785,0,0,0
32156,92,2959948,2958352,1596,0.00053949,0.053948955
32018,30,960269,960540,271,0.000282133,0.028213297
32180,28,902252,901040,1212,0.001345112,0.134511231
32042,164,5255480,5254888,592,0.000112657,0.011265702
32095,34,1092845,1091230,1615,0.001479981,0.147998131
32158,180,5788360,5788440,80,1.38206E-05,0.001382065
32003,13,416039,416039,0,0,0
32129,40,1284652,1285160,508,0.000395282,0.039528152
32009,14,448135,448126,9,2.00836E-05,0.002008364
32041,196,6280036,6280036,0,0,0
32142,197,6331910,6331974,64,1.01074E-05,0.001010743
32009,21,672189,672189,0,0,0
32191,118,3802893,3798538,4355,0.001146494,0.114649373
32139,126,4056885,4049514,7371,0.001820218,0.182021843
32191,103,3319053,3315673,3380,0.001019401,0.101940089
32047,186,5960789,5960742,47,7.88492E-06,0.000788492
32035,168,5382020,5381880,140,2.60132E-05,0.002601321
32072,175,5612519,5612600,81,1.44318E-05,0.001443181
32153,146,4687643,4694338,6695,0.001426186,0.142618618
32086,164,5263400,5262104,1296,0.000246289,0.024628932
32144,175,5625119,5625200,81,1.43995E-05,0.001439949
32086,101,3236542,3240686,4144,0.001278742,0.12787416
32103,68,2183004,2183004,0,0,0
32173,168,5404732,5405064,332,6.14239E-05,0.006142388
32021,92,2945596,2945932,336,0.000114056,0.011405559
32069,33,1059381,1058277,1104,0.001043205,0.104320513
32156,19,610963,610964,1,1.63676E-06,0.000163676
32133,180,5783940,5783940,0,0,0
32182,97,3125190,3121654,3536,0.001132733,0.113273284
32124,74,2377295,2377176,119,5.00594E-05,0.00500594
32079,136,4368116,4362744,5372,0.001231335,0.123133514
32008,87,2784663,2784696,33,1.18505E-05,0.001185049
32010,183,5857709,5857830,121,2.06561E-05,0.002065611
32164,49,1576020,1576036,16,1.01521E-05,0.001015205
32192,60,1931516,1931520,4,2.07091E-06,0.000207091
32132,38,1219387,1221016,1629,0.001334135,0.133413485
32173,147,4724119,4729431,5312,0.00112318,0.112317951
32072,100,3203728,3207200,3472,0.001082564,0.108256423
32055,4,128220,128220,0,0,0
32124,4,128496,128496,0,0,0
32000,18,575999,576000,1,1.73611E-06,0.000173611
32094,175,5616369,5616450,81,1.44219E-05,0.001442192
32049,91,2915675,2916459,784,0.000268819,0.026881914
32099,1,32099,32099,0,0,0
32026,160,5124496,5124160,336,6.55717E-05,0.006557172
130,13715,1802981,1782950,20031,0.011234751,1.12347514
141,9428,858308,1329348,471040,0.35433912,35.43391196
41,31355,621683,1285555,663872,0.516408866,51.64088662
110,23824,2169056,2620640,451584,0.172318212,17.23182123
57,29179,714723,1663203,948480,0.570273142,57.02731416
186,14698,2665513,2733828,68315,0.02498877,2.498877032
100,29399,1296683,2939900,1643217,0.558936358,55.89363584
182,30661,6864334,5580302,1284032,0.230100808,23.01008082
23,7294,72105,167762,95657,0.570194681,57.01946806
26,5265,138490,136890,1600,0.011688217,1.168821682
189,19248,3637872,3637872,0,0,0
27,19050,519561,514350,5211,0.010131234,1.01312336
99,6260,309276,619740,310464,0.500958466,50.09584665
130,5487,721357,713310,8047,0.01128121,1.128121013
40,24976,495680,999040,503360,0.50384369,50.38436899
170,13004,2206260,2210680,4420,0.001999385,0.19993848
19,17220,327180,327180,0,0,0
9,7798,35019,70182,35163,0.501025904,50.10259041
59,6016,298304,354944,56640,0.159574468,15.95744681
43,4739,206529,203777,2752,0.013504959,1.350495885
157,31552,6575680,4953664,1622016,0.32743763,32.743763
176,3874,680191,681824,1633,0.002395046,0.239504623
125,19033,2409625,2379125,30500,0.012819839,1.281983923
73,19361,1414521,1413353,1168,0.000826404,0.082640359
174,8803,1174425,1531722,357297,0.233264914,23.32649136
93,17545,1638009,1631685,6324,0.003875748,0.387574808
148,24436,4065536,3616528,449008,0.124154438,12.41544376
16,14386,245535,230176,15359,0.0667272,6.672720006
127,6388,421132,811276,390144,0.480901691,48.09016907
36,8920,463724,321120,142604,0.444083209,44.40832088
143,12340,1764620,1764620,0,0,0
134,16038,2147169,2149092,1923,0.000894797,0.08947965
142,15873,2224526,2253966,29440,0.013061422,1.306142151
5,1957,4745,9785,5040,0.515074093,51.5074093
64,9208,847612,589312,258300,0.438307722,43.83077215
71,15128,1073236,1074088,852,0.000793231,0.079323109
20,30143,265899,602860,336961,0.558937398,55.89373984
96,21290,2043659,2043840,181,8.85588E-05,0.008855879
39,5100,198900,198900,0,0,0
159,3445,553963,547755,6208,0.011333534,1.133353415
14,6602,44757,92428,47671,0.515763621,51.57636214
120,25688,1602460,3082560,1480100,0.48015286,48.015286
73,25269,947613,1844637,897024,0.486287546,48.6287546
199,5763,1201557,1146837,54720,0.047713843,4.771384251
73,2885,210605,210605,0,0,0
17,8146,68867,138482,69615,0.502700712,50.2700712
12,28673,143372,344076,200704,0.583312989,58.3312989
196,14791,2852107,2899036,46929,0.016187795,1.618779484
152,11476,1739168,1744352,5184,0.002971877,0.297187724
61,25026,761463,1526586,765123,0.501198753,50.11987533
113,8181,461605,924453,462848,0.500672289,50.06722895
15,20557,308355,308355,0,0,0
99,24194,1996137,2395206,399069,0.166611557,16.66115566
116,2192,379392,254272,125120,0.492071483,49.20714825
58,19071,1115973,1106118,9855,0.008909538,0.890953768
69,16463,1135947,1135947,0,0,0
27,32634,437049,881118,444069,0.503983575,50.39835754
8,30329,100580,242632,142052,0.585462758,58.54627584
79,22145,1673615,1749455,75840,0.043350643,4.335064349
89,26554,1178627,2363306,1184679,0.50128041,50.12804097
178,28074,6289809,4997172,1292637,0.258673706,25.86737058
120,3079,367975,369480,1505,0.004073292,0.407329219
194,8419,1374229,1633286,259057,0.158610923,15.8610923
188,9114,1427407,1713432,286025,0.166931048,16.69310483
2,2880,4480,5760,1280,0.222222222,22.22222222
43,10597,497639,455671,41968,0.092101538,9.210153817
32,2945,95200,94240,960,0.010186757,1.018675722
80,22619,1561451,1809520,248069,0.137091052,13.70910518
47,14345,722531,674215,48316,0.0716626,7.166260021
172,11420,1955020,1964240,9220,0.004693927,0.469392742
140,29690,6052927,4156600,1896327,0.456220709,45.62207092
69,25331,899967,1747839,847872,0.485097312,48.50973116
16,21681,346816,346896,80,0.000230617,0.023061667
187,30370,6879169,5679190,1199979,0.21129404,21.12940402
77,14942,1169091,1150534,18557,0.016129032,1.612903226
193,9450,1565739,1823850,258111,0.141519862,14.15198618
171,16354,2795089,2796534,1445,0.000516711,0.051671104
27,26969,313119,728163,415044,0.569987764,56.99877637
109,16831,1806675,1834579,27904,0.015210029,1.521002911
36,32576,582656,1172736,590080,0.503165248,50.31652478
186,22848,4463744,4249728,214016,0.050359929,5.035992892
104,25183,1361687,2619032,1257345,0.480080045,48.00800448
151,26270,5359385,3966770,1392615,0.351070266,35.10702662
24,20016,486256,480384,5872,0.012223554,1.222355449
107,590,90629,63130,27499,0.43559322,43.55932203
71,16587,1177677,1177677,0,0,0
127,2877,365379,365379,0,0,0
10,30688,128848,306880,178032,0.580135558,58.01355579
47,6951,134749,326697,191948,0.587541361,58.7541361
152,27071,5733671,4114792,1618879,0.393429121,39.34291211
58,4042,234425,234436,11,4.69211E-05,0.004692112
118,21983,2561833,2593994,32161,0.012398255,1.239825535
12,289,3644,3468,176,0.050749712,5.074971165
38,14307,501249,543666,42417,0.078020329,7.802032866
186,20592,3834576,3830112,4464,0.001165501,0.116550117
93,18833,1828845,1751469,77376,0.044177773,4.417777306
159,5960,1046580,947640,98940,0.104406737,10.44067367
134,3000,400420,402000,1580,0.003930348,0.393034826
152,13126,1991111,1995152,4041,0.00202541,0.202540959
76,13685,1031084,1040060,8976,0.008630271,0.863027133
32798,1218,39947929,39947964,35,8.7614E-07,8.7614E-05
50214,1156,58049752,58047384,2368,4.07943E-05,0.004079426
34866,1056,36819280,36818496,784,2.12936E-05,0.002129365
37888,1106,41904127,41904128,1,2.3864E-08,2.3864E-06
26670,1147,30587541,30590490,2949,9.64025E-05,0.009640251
39365,1084,42671660,42671660,0,0,0
60665,1026,62242283,62242290,7,1.12464E-07,1.12464E-05
62691,1067,66891297,66891297,0,0,0
5715,1091,6235065,6235065,0,0,0
49659,1039,51595701,51595701,0,0,0
56390,1121,63209814,63213190,3376,5.34066E-05,0.005340658
64105,1040,66669200,66669200,0,0,0
38714,1137,44014090,44017818,3728,8.4693E-05,0.008469298
42844,1048,44899404,44900512,1108,2.46768E-05,0.002467678
16851,1211,20406561,20406561,0,0,0
21348,1135,24223563,24229980,6417,0.000264837,0.02648372
27751,1149,31879307,31885899,6592,0.000206737,0.020673715
32722,1133,37076950,37074026,2924,7.88692E-05,0.007886923
36040,1060,38201488,38202400,912,2.38728E-05,0.002387285
42594,1024,43616256,43616256,0,0,0
39765,1211,48155415,48155415,0,0,0
28183,1038,29253977,29253954,23,7.86219E-07,7.86219E-05
2121,1070,2269543,2269470,73,3.21661E-05,0.00321661
8796,1074,9446979,9446904,75,7.93911E-06,0.000793911
40979,1159,47495801,47494661,1140,2.40027E-05,0.00240027
23933,1079,25823207,25823707,500,1.93621E-05,0.001936205
10931,1080,11805172,11805480,308,2.60896E-05,0.002608958
38784,1125,43638128,43632000,6128,0.000140447,0.014044738
5547,1048,5814276,5813256,1020,0.000175461,0.017546105
27237,1081,29443601,29443197,404,1.37213E-05,0.001372134
39436,1151,45390067,45390836,769,1.69417E-05,0.001694175
36567,1152,42122560,42125184,2624,6.22905E-05,0.006229053
3675,1049,3853983,3855075,1092,0.000283263,0.028326297
30730,1222,37551965,37552060,95,2.52982E-06,0.000252982
2521,1191,3002043,3002511,468,0.00015587,0.015586954
55243,1046,57784337,57784178,159,2.75162E-06,0.000275162
17766,1142,20281921,20288772,6851,0.000337674,0.033767445
3782,1073,4058070,4058086,16,3.94275E-06,0.000394275
40853,1170,47791055,47798010,6955,0.000145508,0.014550815
5359,1097,5878755,5878823,68,1.15669E-05,0.001156694
2839,1121,3181415,3182519,1104,0.000346895,0.034689502
25065,1111,27847307,27847215,92,3.30374E-06,0.000330374
19788,1136,22474288,22479168,4880,0.00021709,0.021708989
64900,1027,66652299,66652300,1,1.50032E-08,1.50032E-06
56365,1046,58957655,58957790,135,2.28977E-06,0.000228977
50766,1210,61426869,61426860,9,1.46516E-07,1.46516E-05
54395,1115,60648457,60650425,1968,3.24482E-05,0.003244825
13372,1191,15926691,15926052,639,4.01229E-05,0.004012294
49252,1158,57039851,57033816,6035,0.000105814,0.010581442
65366,1059,69223953,69222594,1359,1.96323E-05,0.001963232
34556,1099,37977039,37977044,5,1.31658E-07,1.31658E-05
8146,1034,8422913,8422964,51,6.05488E-06,0.000605488
38500,1204,46353920,46354000,80,1.72585E-06,0.000172585
30255,1162,35159365,35156310,3055,8.68976E-05,0.008689763
53716,1181,63436416,63438596,2180,3.43639E-05,0.003436394
16413,1129,18528537,18530277,1740,9.39004E-05,0.009390038
53577,1181,63277941,63274437,3504,5.53778E-05,0.005537781
2738,1096,3000532,3000848,316,0.000105304,0.010530357
31856,1197,38131548,38131632,84,2.2029E-06,0.00022029
31597,1091,34472327,34472327,0,0,0
12838,1199,15392681,15392762,81,5.26221E-06,0.000526221
35249,1068,37645932,37645932,0,0,0
46974,1066,50074389,50074284,105,2.09688E-06,0.000209688
858,1050,899545,900900,1355,0.001504052,0.15040515
9809,1037,10171933,10171933,0,0,0
7007,1037,7266259,7266259,0,0,0
56170,1126,63241997,63247420,5423,8.57426E-05,0.008574263
11479,1210,13889549,13889590,41,2.95185E-06,0.000295185
62922,1067,67137753,67137774,21,3.1279E-07,3.1279E-05
24201,1029,24902829,24902829,0,0,0
64054,1084,69434532,69434536,4,5.76082E-08,5.76082E-06
45503,1143,52014349,52009929,4420,8.49838E-05,0.008498377
41476,1114,46204199,46204264,65,1.4068E-06,0.00014068
10413,1109,11548017,11548017,0,0,0
5460,1075,5869483,5869500,17,2.89633E-06,0.000289633
3050,1078,3287949,3287900,49,1.49031E-05,0.001490313
38537,1038,40001287,40001406,119,2.9749E-06,0.00029749
16464,1039,17106095,17106096,1,5.84587E-08,5.84587E-06
10672,1101,11749868,11749872,4,3.40429E-07,3.40429E-05
27282,1041,28400562,28400562,0,0,0
62903,1104,69444912,69444912,0,0,0
31729,1184,37566896,37567136,240,6.38856E-06,0.000638856
542,1201,650862,650942,80,0.000122899,0.012289881
20868,1210,25250087,25250280,193,7.64348E-06,0.000764348
59426,1139,67684021,67686214,2193,3.23995E-05,0.003239951
5329,1142,6088867,6085718,3149,0.000517441,0.0517441
42119,1206,50795877,50795514,363,7.1463E-06,0.00071463
11373,1118,12713379,12715014,1635,0.000128588,0.012858814
22731,1075,24435825,24435825,0,0,0
20186,1193,24081662,24081898,236,9.79989E-06,0.000979989
44503,1157,51487347,51489971,2624,5.09614E-05,0.005096138
26847,1045,28055115,28055115,0,0,0
43737,1181,51651525,51653397,1872,3.62416E-05,0.003624157
9295,1139,10581949,10587005,5056,0.000477567,0.04775666
20513,1055,21640687,21641215,528,2.43979E-05,0.002439789
31460,1068,33599260,33599280,20,5.95251E-07,5.95251E-05
12523,1046,13099121,13099058,63,4.80951E-06,0.000480951
35937,1204,43268148,43268148,0,0,0
7052,1123,7924947,7919396,5551,0.000700937,0.070093729
39830,1057,42098598,42100310,1712,4.06648E-05,0.004066478
467,17201,8032867,8032867,0,0,0
599,59746,35872853,35787854,84999,0.00237508,0.237507955
194,27853,6414102,5403482,1010620,0.187031251,18.70312513
371,28141,8526711,10440311,1913600,0.183289559,18.32895591
112,18981,2155040,2125872,29168,0.013720487,1.37204874
554,9233,5283018,5115082,167936,0.032831536,3.283153623
852,58680,50335660,49995360,340300,0.006806632,0.680663166
650,4515,2962989,2934750,28239,0.009622285,0.962228469
612,27096,15014764,16582752,1567988,0.094555355,9.455535487
1011,7638,7778633,7722018,56615,0.007331633,0.733163274
163,11558,1882745,1883954,1209,0.000641735,0.064173541
183,12831,2330553,2348073,17520,0.007461438,0.746143753
806,17114,13792989,13793884,895,6.48838E-05,0.006488383
577,6940,3737100,4004380,267280,0.066746912,6.674691213
536,14322,7647927,7676592,28665,0.003734079,0.373407887
34,59884,2057028,2036056,20972,0.010300306,1.030030608
731,5574,4084177,4074594,9583,0.002351891,0.235189077
975,3430,3346749,3344250,2499,0.000747253,0.074725275
232,34353,7578456,7969896,391440,0.049114819,4.911481906
635,46508,29501092,29532580,31488,0.001066212,0.10662123
622,63099,39151701,39247578,95877,0.002442877,0.244287686
467,59721,27843447,27889707,46260,0.001658676,0.165867644
355,320,113600,113600,0,0,0
510,47648,24282256,24300480,18224,0.000749944,0.074994403
780,39202,30720083,30577560,142523,0.004661032,0.466103247
693,57712,39692016,39994416,302400,0.007561056,0.756105552
412,4138,1704735,1704856,121,7.09737E-05,0.007097374
722,47892,34560360,34578024,17664,0.000510845,0.051084469
257,12012,3087084,3087084,0,0,0
799,11504,9191696,9191696,0,0,0
884,58628,52298192,51827152,471040,0.009088672,0.908867229
720,57263,41409503,41229360,180143,0.004369289,0.436928926
494,47407,23383201,23419058,35857,0.001531103,0.153110343
369,37250,15575059,13745250,1829809,0.133123006,13.31230061
7,62763,439341,439341,0,0,0
421,11339,4773719,4773719,0,0,0
620,15179,9409695,9410980,1285,0.000136543,0.013654263
404,63234,25652667,25546536,106131,0.004154418,0.415441843
117,59388,7307820,6948396,359424,0.051727622,5.172762174
339,45134,15300509,15300426,83,5.42469E-06,0.000542469
254,41117,10414882,10443718,28836,0.002761086,0.276108566
302,20465,6180414,6180430,16,2.58882E-06,0.000258882
14,32884,672456,460376,212080,0.460666933,46.06669331
280,42027,11845363,11767560,77803,0.006611651,0.661165101
627,32049,18210563,20094723,1884160,0.09376392,9.376392001
563,41969,23837443,23628547,208896,0.008840831,0.884083139
990,6517,6557414,6451830,105584,0.016364969,1.636496932
172,8534,1119939,1467848,347909,0.237019773,23.70197732
926,25833,25121074,23921358,1199716,0.050152504,5.015250388
474,33770,15367945,16006980,639035,0.039922271,3.992227141
405,18,7183,7290,107,0.014677641,1.46776406
488,30676,15383520,14969888,413632,0.027630935,2.763093485
113,16109,1820317,1820317,0,0,0
495,34331,16728645,16993845,265200,0.01560565,1.560565016
468,28453,14031828,13316004,715824,0.053756668,5.375666754
712,41494,29279447,29543728,264281,0.008945418,0.894541813
631,63773,40360715,40240763,119952,0.002980858,0.298085799
133,23089,3543157,3070837,472320,0.153808229,15.38082288
987,28631,28865153,28258797,606356,0.021457247,2.145724745
973,8007,7999911,7790811,209100,0.026839311,2.683931108
691,28918,21244137,19982338,1261799,0.063145714,6.314571398
524,44992,23555264,23575808,20544,0.000871402,0.087140174
652,25122,17768915,16379544,1389371,0.084823546,8.482354576
704,51520,36187136,36270080,82944,0.002286844,0.228684359
726,51369,37233226,37293894,60668,0.001626754,0.162675423
449,50262,22567827,22567638,189,8.37482E-06,0.000837482
734,20070,14724137,14731380,7243,0.000491672,0.049167152
983,16476,16196564,16195908,656,4.05041E-05,0.004050406
989,31215,31418195,30871635,546560,0.017704278,1.770427773
129,48903,6308995,6308487,508,8.05264E-05,0.008052644
933,55306,51879959,51600498,279461,0.005415859,0.541585858
309,9354,3110919,2890386,220533,0.076298806,7.629880577
14,34372,683192,481208,201984,0.419743645,41.97436452
511,60833,31085903,31085663,240,7.7206E-06,0.00077206
699,16346,11426889,11425854,1035,9.0584E-05,0.009058404
207,13701,2845515,2836107,9408,0.003317223,0.331722322
75,55219,4064625,4141425,76800,0.018544342,1.854434162
596,32691,18107499,19483836,1376337,0.07063994,7.063993969
398,49107,19528137,19544586,16449,0.000841614,0.084161414
688,61317,42176816,42186096,9280,0.000219978,0.021997769
216,63500,13674012,13716000,41988,0.003061242,0.306124234
499,15192,7580964,7580808,156,2.05783E-05,0.002057828
778,63496,49409140,49399888,9252,0.000187288,0.018728787
410,2585,1033678,1059850,26172,0.02469406,2.469406048
875,62532,54715500,54715500,0,0,0
510,51560,26276244,26295600,19356,0.000736093,0.073609273
739,58887,43421097,43517493,96396,0.002215109,0.221510922
519,51848,26909588,26909112,476,1.76892E-05,0.001768918
177,39685,6053493,7024245,970752,0.138200191,13.82001909
244,56597,13841412,13809668,31744,0.002298679,0.229867945
577,51432,29743084,29676264,66820,0.002251631,0.225163114
403,63694,25556957,25668682,111725,0.00435258,0.435258032
802,58923,47365025,47256246,108779,0.002301897,0.230189677
970,9434,8926441,9150980,224539,0.024537153,2.45371534
460,42666,19445743,19626360,180617,0.009202776,0.920277627
183,36324,5468780,6647292,1178512,0.177292046,17.72920461
831,34403,29569677,28588893,980784,0.03430647,3.430647
344,46643,15956855,16045192,88337,0.005505512,0.550551218
789,35809,28597701,28253301,344400,0.012189726,1.218972608
754,22751,17196397,17154254,42143,0.002456708,0.245670841
298,5380,1603240,1603240,0,0,0
562,41557,23551898,23355034,196864,0.008429189,0.842918918
865,47745,41305633,41299425,6208,0.000150317,0.015031686
328,1904,545904,624512,78608,0.12587108,12.58710801
936,600,539868,561600,21732,0.038696581,3.86965812
216,63338,13720115,13681008,39107,0.002858488,0.28584882
471,19610,9234301,9236310,2009,0.000217511,0.021751111
806,20660,16651880,16651960,80,4.80424E-06,0.000480424
628,10749,6834336,6750372,83964,0.012438426,1.243842562
70,39623,3615761,2773610,842151,0.303629926,30.36299263
262,61413,16086190,16090206,4016,0.000249593,0.024959283
937,41759,38773223,39128183,354960,0.009071722,0.907172204
1021,27222,27842055,27793662,48393,0.001741152,0.174115235
237,63208,14999676,14980296,19380,0.001293699,0.12936994
469,2153,968305,1009757,41452,0.041051461,4.10514609
313,38162,12878651,11944706,933945,0.078189032,7.818903203
644,45529,29333360,29320676,12684,0.000432596,0.043259576
514,21723,11165521,11165622,101,9.04562E-06,0.000904562
460,59959,27562643,27581140,18497,0.000670639,0.067063943
917,17140,15717380,15717380,0,0,0
145,60239,8734655,8734655,0,0,0
819,59857,49062051,49022883,39168,0.000798974,0.079897382
189,31729,7094509,5996781,1097728,0.183052875,18.30528745
46,11489,524094,528494,4400,0.008325544,0.83255439
213,51443,10913327,10957359,44032,0.004018487,0.401848657
185,56139,10676531,10385715,290816,0.028001539,2.800153865
979,59492,58198748,58242668,43920,0.000754086,0.075408633
239,20,4780,4780,0,0,0
350,8603,3372357,3011050,361307,0.11999369,11.99936899
968,42644,41082976,41279392,196416,0.00475821,0.475820962
505,54489,27517029,27516945,84,3.05266E-06,0.000305266
352,8640,3405760,3041280,364480,0.119844276,11.98442761
568,2626,1504679,1491568,13111,0.008790079,0.879007863
874,49021,42820926,42844354,23428,0.000546817,0.054681651
423,32142,15071241,13596066,1475175,0.108500135,10.85001353
549,57942,31971071,31810158,160913,0.005058541,0.505854136
355,63817,22756807,22655035,101772,0.004492246,0.449224643
938,25817,25269982,24216346,1053636,0.043509289,4.350928914
15,30769,231135,461535,230400,0.499203744,49.9203744
742,24772,18696152,18380824,315328,0.01715527,1.715527008
563,15194,8553457,8554222,765,8.94295E-05,0.008942952
298,51390,15339797,15314220,25577,0.001670147,0.167014709
931,20577,19161651,19157187,4464,0.00023302,0.02330196
654,34937,20853714,22848798,1995084,0.087316803,8.731680327
517,30734,15812683,15889478,76795,0.004833073,0.483307255
792,29071,22622247,23024232,401985,0.017459214,1.745921427
5,51407,262155,257035,5120,0.019919466,1.991946622
1008,21806,21980415,21980448,33,1.50133E-06,0.000150133
96,59230,5975199,5686080,289119,0.050846805,5.084680483
894,49375,44122785,44141250,18465,0.000418316,0.04183162
334,59628,19990484,19915752,74732,0.003752407,0.375240664
201,7886,1810311,1585086,225225,0.142090082,14.20900822
621,18437,11560993,11449377,111616,0.009748653,0.97486527
1013,65035,65877639,65880455,2816,4.27441E-05,0.004274409
189,55642,10723167,10516338,206829,0.019667398,1.966739753
294,45386,13323037,13343484,20447,0.001532358,0.153235842
977,28174,28283967,27525998,757969,0.027536477,2.753647661
187,13887,2649861,2596869,52992,0.020406112,2.040611213
702,23378,16680345,16411356,268989,0.016390419,1.639041893
289,62018,17931683,17923202,8481,0.000473186,0.047318554
747,49306,36830553,36831582,1029,2.7938E-05,0.002793798
547,56145,30567955,30711315,143360,0.004667986,0.466798638
599,12421,7445747,7440179,5568,0.000748369,0.074836909
266,23363,6172317,6214558,42241,0.006797104,0.679710448
620,27649,15367788,17142380,1774592,0.103520748,10.3520748
617,11877,7349949,7328109,21840,0.002980305,0.298030501
501,7095,3599695,3554595,45100,0.012687803,1.268780269
1000,15676,15674972,15676000,1028,6.5578E-05,0.006557795
84,22166,1780731,1861944,81213,0.043617316,4.36173161
999,16064,16047936,16047936,0,0,0
913,38764,33693676,35391532,1697856,0.04797351,4.79735096
89,56569,4670453,5034641,364188,0.072336439,7.233643869
77,50040,3848460,3853080,4620,0.001199041,0.119904077
419,59514,24846993,24936366,89373,0.003584043,0.358404268
67,43325,2971383,2902775,68608,0.023635314,2.363531448
474,61782,29280685,29284668,3983,0.00013601,0.013600974
355,45473,16119155,16142915,23760,0.001471853,0.147185313
582,29194,15857661,16990908,1133247,0.066697259,6.66972595
806,52708,42456104,42482648,26544,0.00062482,0.062481981
616,26734,14859015,16468144,1609129,0.097711618,9.771161826
805,12176,9804048,9801680,2368,0.000241591,0.024159124
369,47544,17630972,17543736,87236,0.004972487,0.497248705
934,25326,24755945,23654484,1101461,0.046564575,4.656457524
127,27115,1460373,3443605,1983232,0.575917389,57.59173889
25,9267,334075,231675,102400,0.441998489,44.19984893
874,40156,36379700,35096344,1283356,0.036566658,3.656665777
813,13635,11085255,11085255,0,0,0
901,31157,29993225,28072457,1920768,0.068421799,6.842179863
923,4934,4554385,4554082,303,6.65337E-05,0.006653372
818,40312,33569204,32975216,593988,0.018013165,1.80131648
42,16268,685876,683256,2620,0.00383458,0.38345803
646,11965,7724970,7729390,4420,0.000571843,0.057184331
793,34895,28106935,27671735,435200,0.015727239,1.572723937
761,37776,28632400,28747536,115136,0.004005074,0.400507369
638,48923,31194213,31212874,18661,0.000597862,0.059786228
346,39851,14876873,13788446,1088427,0.078937612,7.893761197
172,14279,2538179,2455988,82191,0.033465554,3.346555439
242,4868,1177800,1178056,256,0.000217307,0.021730716
839,34444,29993620,28898516,1095104,0.037894818,3.789481785
552,47593,26284788,26271336,13452,0.000512041,0.051204096
40721,20255,824803583,824803855,272,3.29775E-07,3.29775E-05
28800,13031,375286895,375292800,5905,1.57344E-05,0.001573438
39435,29370,1158025737,1158205950,180213,0.000155597,0.015559668
11592,31113,359541348,360661896,1120548,0.003106921,0.310692095
41736,9869,411913252,411892584,20668,5.01781E-05,0.005017813
51152,17217,880683728,880683984,256,2.90683E-07,2.90683E-05
35139,18458,648663265,648595662,67603,0.00010423,0.010422981
59783,20421,1220828643,1220828643,0,0,0
53775,28414,1527717105,1527962850,245745,0.000160832,0.016083179
457,6763,3305411,3090691,214720,0.069473137,6.947313724
53317,31312,1668349072,1669461904,1112832,0.000666581,0.066658125
14538,24165,351520450,351310770,209680,0.00059685,0.059685048
36472,1556,56658016,56750432,92416,0.001628463,0.162846337
31839,5749,182963371,183042411,79040,0.000431812,0.043181249
54930,28271,1554702781,1552926030,1776751,0.001144131,0.114413112
31504,656,20667328,20666624,704,3.40646E-05,0.003406459
13547,19932,270024516,270018804,5712,2.11541E-05,0.002115408
40260,7546,303518119,303801960,283841,0.000934296,0.093429614
62588,32546,2034959267,2036989048,2029781,0.000996461,0.099646142
4054,8118,33082449,32910372,172077,0.005228656,0.522865557
9529,8488,81115852,80882152,233700,0.002889389,0.2889389
48895,2266,110795061,110796070,1009,9.10682E-06,0.000910682
36661,3714,136162399,136158954,3445,2.53013E-05,0.002530131
22488,5047,113497015,113496936,79,6.96054E-07,6.96054E-05
49311,26065,1286507983,1285291215,1216768,0.000946687,0.094668662
17501,15179,265647679,265647679,0,0,0
1082,32705,34436474,35386810,950336,0.026855656,2.68556561
45881,15856,727474544,727489136,14592,2.0058E-05,0.002005803
26460,30933,817072972,818487180,1414208,0.001727832,0.172783158
35909,5588,200641828,200659492,17664,8.80297E-05,0.008802973
46107,11449,527879151,527879043,108,2.04592E-07,2.04592E-05
33279,32537,1082815219,1082798823,16396,1.51422E-05,0.001514224
31150,14935,465203305,465225250,21945,4.71707E-05,0.00471707
63975,30117,1927150675,1926735075,415600,0.000215702,0.021570168
169,31582,6764071,5337358,1426713,0.267306971,26.7306971
8444,13845,116905900,116907180,1280,1.09489E-05,0.001094886
22058,2942,64890709,64894636,3927,6.05135E-05,0.006051348
59221,15563,921656423,921656423,0,0,0
18048,18185,328333180,328202880,130300,0.000397011,0.039701053
62733,17810,1117272247,1117274730,2483,2.22237E-06,0.000222237
24445,18995,464364775,464332775,32000,6.89161E-05,0.006891609
47219,19400,916049060,916048600,460,5.02157E-07,5.02157E-05
59889,29611,1773618939,1773373179,245760,0.000138583,0.013858335
23744,2706,64245759,64251264,5505,8.56792E-05,0.008567925
61824,23233,1436879936,1436356992,522944,0.000364077,0.036407662
52295,9,470939,470655,284,0.000603414,0.060341439
17742,23767,421353225,421674114,320889,0.000760988,0.076098814
46677,27094,1263339023,1264666638,1327615,0.001049775,0.104977467
28600,6481,185576760,185356600,220160,0.001187765,0.118776456
33972,16194,550142235,550142568,333,6.05298E-07,6.05298E-05
48278,26295,1270877073,1269470010,1407063,0.001108386,0.110838617
25632,15392,394527216,394527744,528,1.33831E-06,0.000133831
14640,25935,379094479,379688400,593921,0.001564233,0.156423267
16004,24988,401453292,399907952,1545340,0.003864239,0.386423924
44669,28375,1265434375,1267482875,2048500,0.001616195,0.161619541
50513,26969,1361039965,1362285097,1245132,0.000914003,0.091400251
43954,8356,366954712,367279624,324912,0.000884645,0.088464477
24032,19671,472732511,472733472,961,2.03286E-06,0.000203286
31449,22228,699088308,699048372,39936,5.71291E-05,0.005712909
14097,19104,269309360,269309088,272,1.00999E-06,0.000100999
10852,11477,124543220,124548404,5184,4.16224E-05,0.004162237
15651,24118,377336313,377470818,134505,0.000356332,0.035633218
33903,31981,1082433219,1084251843,1818624,0.001677308,0.167730773
7176,17192,123369548,123369792,244,1.97779E-06,0.000197779
5569,26118,146273859,145451142,822717,0.005656312,0.565631173
16397,30559,500849411,501075923,226512,0.000452051,0.045205126
9755,17008,165918224,165913040,5184,3.12453E-05,0.003124528
54848,13316,730351872,730355968,4096,5.60822E-06,0.000560822
51448,12244,629925152,629929312,4160,6.60392E-06,0.000660392
51538,30220,1556067540,1557478360,1410820,0.000905836,0.090583602
50521,1548,78138156,78206508,68352,0.000873994,0.087399376
50023,31436,1570835476,1572523028,1687552,0.001073149,0.107314931
43170,26137,1129558326,1128334290,1224036,0.001084817,0.108481681
12435,15524,193039196,193040940,1744,9.03435E-06,0.000903435
48695,11259,548257005,548257005,0,0,0
16756,31013,517872884,519653828,1780944,0.003427174,0.342717383
5345,28551,153111139,152605095,506044,0.003316036,0.331603607
57005,11189,637828945,637828945,0,0,0
29338,3094,90771053,90771772,719,7.92096E-06,0.000792096
45991,3881,178490715,178491071,356,1.9945E-06,0.00019945
26839,9256,248253684,248421784,168100,0.000676672,0.067667174
11372,7750,87717699,88133000,415301,0.004712208,0.471220769
17129,4034,69098363,69098386,23,3.32859E-07,3.32859E-05
31215,6826,213143205,213073590,69615,0.000326718,0.032671811
2950,27071,81759417,79859450,1899967,0.023791386,2.379138599
33186,31503,1046997373,1045458558,1538815,0.001471904,0.147190435
35870,4031,144591905,144591970,65,4.49541E-07,4.49541E-05
61610,32607,2010327413,2008917270,1410143,0.000701942,0.07019418
22024,7171,157900311,157934104,33793,0.000213969,0.021396899
13971,7829,109818447,109378959,439488,0.004018031,0.401803056
45865,28629,1312397341,1313069085,671744,0.000511583,0.051158314
31435,6629,208558151,208382615,175536,0.000842374,0.084237353
44328,8388,371982944,371823264,159680,0.000429451,0.042945134
45008,26649,1200150924,1199418192,732732,0.000610906,0.061090619
5057,3175,16059251,16055975,3276,0.000204036,0.020403619
31323,18857,590728063,590657811,70252,0.000118939,0.011893858
28257,21475,606820627,606819075,1552,2.5576E-06,0.00025576
19044,14711,280250843,280156284,94559,0.000337522,0.033752232
3724,19424,72332080,72334976,2896,4.0036E-05,0.004003596
19292,29105,559958604,561493660,1535056,0.002733879,0.273387949
64568,4919,317609495,317609992,497,1.56481E-06,0.000156481
26730,29142,777197341,778965660,1768319,0.002270086,0.227008595
1195,1537,1901995,1836715,65280,0.035541714,3.554171442
20238,28735,581305457,581538930,233473,0.000401474,0.040147441
46581,16968,790383548,790386408,2860,3.61848E-06,0.000361848
27645,28484,787489332,787440180,49152,6.242E-05,0.006241998
22180,8976,198706496,199087680,381184,0.001914654,0.191465389
59279,10074,596831205,597176646,345441,0.000578457,0.057845698
63169,17392,1098635248,1098635248,0,0,0
44689,5420,242214380,242214380,0,0,0
25265,31980,809269036,807974700,1294336,0.001601951,0.160195115
29153,29747,867722195,867214291,507904,0.000585673,0.058567301
9245,29145,268962617,269445525,482908,0.001792229,0.179222869
38558,16810,648184885,648159980,24905,3.84242E-05,0.003842416
34916,30707,1070420699,1072165612,1744913,0.001627466,0.162746593
19531,14705,287275355,287203355,72000,0.000250693,0.025069345
40385,11742,474217743,474200670,17073,3.60037E-05,0.003600374
33210,21958,729243245,729225180,18065,2.47729E-05,0.002477287
11703,28633,336288907,335091999,1196908,0.003571879,0.357187878
56605,21075,1192957799,1192950375,7424,6.22323E-06,0.000622323
49365,22854,1128319935,1128187710,132225,0.000117201,0.011720124
53000,12424,658468380,658472000,3620,5.49758E-06,0.000549758
43383,18003,780932757,781024149,91392,0.000117016,0.011701559
33233,9912,329260924,329405496,144572,0.000438888,0.043888764
61581,21992,1354318332,1354289352,28980,2.13987E-05,0.002139868
56844,12529,712194364,712198476,4112,5.77367E-06,0.000577367
24845,23976,595627196,595683720,56524,9.48893E-05,0.009488928
38545,3592,138424780,138453640,28860,0.000208445,0.020844522
35362,32550,1150476213,1151033100,556887,0.000483815,0.048381493
5085,15056,76559760,76559760,0,0,0
46506,4893,227554974,227553858,1116,4.90433E-06,0.000490433
32282,28409,916669102,917099338,430236,0.000469127,0.046912693
60975,14029,855370147,855418275,48128,5.62625E-05,0.005626253
51388,10878,558980163,558998664,18501,3.30967E-05,0.003309668
722,18248,13221716,13175056,46660,0.003541541,0.354154092
40442,9783,395619773,395644086,24313,6.14517E-05,0.00614517
32619,24534,799835953,800274546,438593,0.000548053,0.054805317
25090,24939,625690689,625719510,28821,4.60606E-05,0.004606057
44103,23099,1018462557,1018735197,272640,0.000267626,0.026762597
19258,5611,108041769,108056638,14869,0.000137604,0.013760376
39109,21762,851089999,851090058,59,6.93229E-08,6.93229E-06
15989,16289,260446693,260444821,1872,7.1877E-06,0.00071877
4434,11671,51727957,51749214,21257,0.00041077,0.041076952
60763,6688,406034960,406382944,347984,0.000856296,0.085629578
40670,31580,1284914916,1284358600,556316,0.000433147,0.043314694
48891,8722,426405537,426427302,21765,5.10404E-05,0.005104035
37234,7800,289980340,290425200,444860,0.001531754,0.153175413
58302,5648,329340128,329289696,50432,0.000153154,0.01531539
61669,12437,766975625,766977353,1728,2.253E-06,0.0002253
16815,28627,482690109,481363005,1327104,0.002756971,0.275697132
35429,3909,138491961,138491961,0,0,0
35682,26689,950806498,952316898,1510400,0.001586027,0.158602667
60624,21829,1323361296,1323361296,0,0,0
10064,51,513247,513264,17,3.31214E-05,0.003312136
24977,24414,610244799,609788478,456321,0.000748327,0.07483267
17676,29589,522815164,523015164,200000,0.000382398,0.038239809
62202,18186,1131211449,1131205572,5877,5.19534E-06,0.000519534
53528,15280,817906736,817907840,1104,1.34979E-06,0.000134979
28882,27822,804303421,803555004,748417,0.000931382,0.093138241
29638,5423,160726857,160726874,17,1.05769E-07,1.05769E-05
25881,26758,692141323,692523798,382475,0.000552291,0.055229149
39658,32208,1277669856,1277304864,364992,0.000285752,0.028575167
6820,6934,47665707,47289880,375827,0.007947303,0.794730289
30148,11573,348897668,348902804,5136,1.47204E-05,0.001472043
41122,6975,287209693,286825950,383743,0.001337895,0.133789498
60396,9686,584914755,584995656,80901,0.000138293,0.013829333
50094,18368,920210496,920126592,83904,9.11875E-05,0.009118745
43431,7294,317155865,316785714,370151,0.001168459,0.116845863
2169,15195,32956019,32957955,1936,5.87415E-05,0.005874151
7026,4700,33049300,33022200,27100,0.00082066,0.082066004
50091,21066,1055195161,1055217006,21845,2.07019E-05,0.00207019
28191,17172,484095852,484095852,0,0,0
64531,10566,681853945,681834546,19399,2.84512E-05,0.002845118
36954,10696,395324276,395259984,64292,0.000162657,0.01626575
32698,7640,250117108,249812720,304388,0.001218465,0.121846478
10736,32669,350995692,350734384,261308,0.000745031,0.074503103
56306,18216,1025684100,1025670096,14004,1.36535E-05,0.001365351
43189,17825,769861925,769843925,18000,2.33814E-05,0.002338136
22018,1537,33839874,33841666,1792,5.29525E-05,0.005295248
13905,13729,190882305,190901745,19440,0.000101832,0.010183249
889,29771,24483955,26466419,1982464,0.074904882,7.49048823
50146,18636,934489044,934520856,31812,3.4041E-05,0.003404097
43205,28577,1235634997,1234669285,965712,0.000782162,0.078216249
63412,16052,1017889088,1017889424,336,3.30095E-07,3.30095E-05
54830,4183,229353705,229353890,185,8.06614E-07,8.06614E-05
16638,4763,79246373,79246794,421,5.31252E-06,0.000531252
54979,14213,781475087,781416527,58560,7.49408E-05,0.007494083
51942,121,6286538,6284982,1556,0.000247574,0.02475743
46163,31345,1445635299,1446979235,1343936,0.000928787,0.092878734
33206,1227,40743693,40743762,69,1.69351E-06,0.000169351
16140,15609,251928280,251929260,980,3.88998E-06,0.000388998
4241,23435,99835387,99387835,447552,0.004503086,0.450308632
65246,5179,337909029,337909034,5,1.47969E-08,1.47969E-06
58748,32344,1898143692,1900145312,2001620,0.001053404,0.105340365
16934,25147,425377725,425839298,461573,0.001083914,0.108391358
10531,11075,116630825,116630825,0,0,0
5335,16051,85632085,85632085,0,0,0
51994,23859,1240417309,1240524846,107537,8.66867E-05,0.00866867
16538,1737,28830222,28726506,103716,0.003610463,0.361046345
29965,21089,631934589,631931885,2704,4.27894E-06,0.000427894
21524,22255,478995867,479016620,20753,4.33242E-05,0.004332418
38049,1243,47296427,47294907,1520,3.21388E-05,0.003213877
39647,2957,117234067,117236179,2112,1.80149E-05,0.001801492
21864,12433,271837608,271835112,2496,9.18204E-06,0.000918204
8017,15554,124696499,124696418,81,6.49578E-07,6.49578E-05
41409,21460,888637140,888637140,0,0,0
44710,19693,880472986,880474030,1044,1.18572E-06,0.000118572
9976,9427,94006823,94043752,36929,0.000392679,0.039267893
54700,21300,1165109728,1165110000,272,2.33454E-07,2.33454E-05
20604,10235,211258767,210881940,376827,0.00178691,0.178690978
57218,11966,684666045,684670588,4543,6.63531E-06,0.000663531
19342,4290,82977001,82977180,179,2.15722E-06,0.000215722
54657,30951,1693638003,1691688807,1949196,0.001152219,0.115221901
564,25538,13760347,14403432,643085,0.044648039,4.464803944
35061,3599,126181723,126184539,2816,2.23165E-05,0.002231652
9164,21689,198757720,198757996,276,1.38862E-06,0.000138862
32933,3155,103903615,103903615,0,0,0
6433,25666,164703907,165109378,405471,0.002455772,0.245577208
3549,19671,69812519,69812379,140,2.00538E-06,0.000200538
3912,20190,78981879,78983280,1401,1.77379E-05,0.001773793
14846,28644,425277448,425248824,28624,6.73112E-05,0.006731118
61480,3637,223612728,223602760,9968,4.45791E-05,0.004457906
53050,19848,1052924404,1052936400,11996,1.13929E-05,0.00113929
27916,24839,693253923,693405524,151601,0.000218633,0.021863252
23172,509,11826288,11794548,31740,0.002691074,0.269107388
60677,16333,991037441,991037441,0,0,0
10334,26748,274958852,276413832,1454980,0.005263774,0.526377421
40576,27005,1097724028,1095754880,1969148,0.00179707,0.17970698
18324,8913,162875028,163321812,446784,0.002735605,0.273560521
27368,22376,612412108,612386368,25740,4.20323E-05,0.004203229
32373,1859,60061599,60181407,119808,0.001990781,0.199078097
677,18602,12500279,12593554,93275,0.007406567,0.740656688
24243,12841,311284343,311304363,20020,6.43101E-05,0.006431005
52574,14124,742454548,742555176,100628,0.000135516,0.013551586
12657,467,5881891,5910819,28928,0.004894076,0.489407644
63934,24477,1565179618,1564912518,267100,0.00017068,0.017068047
164,4350,713307,713400,93,0.000130362,0.013036165
29614,15737,466039410,466035518,3892,8.35129E-06,0.000835129
40020,15767,630977787,630995340,17553,2.7818E-05,0.002781796
58189,2927,170314275,170319203,4928,2.89339E-05,0.002893391
36835,7928,292146548,292027880,118668,0.000406358,0.040635846
47235,18500,873719500,873847500,128000,0.000146479,0.014647865
9438,5215,49219713,49219170,543,1.10323E-05,0.001103229
8318,12172,101250596,101246696,3900,3.85198E-05,0.003851978
26756,15825,423444356,423413700,30656,7.2402E-05,0.0072402
1030,15690,16159677,16160700,1023,6.33017E-05,0.006330171
9875,28461,282838231,281052375,1785856,0.006354175,0.635417509
4324,10970,47429255,47434280,5025,0.000105936,0.010593604
60778,18577,1129187146,1129072906,114240,0.00010118,0.010118036
45133,30508,1375577148,1376917564,1340416,0.00097349,0.097349038
1322,9445,12654882,12486290,168592,0.013502169,1.350216918
5019,24001,120900571,120461019,439552,0.003648915,0.364891484
31458,8875,279062433,279189750,127317,0.000456023,0.045602319
8751,22882,200093789,200240382,146593,0.000732085,0.07320851
7257,7388,53248748,53614716,365968,0.006825887,0.682588713
35026,9998,350044237,350189948,145711,0.000416091,0.041609133
29857,11522,344012259,344012354,95,2.76153E-07,2.76153E-05
46711,16657,778065127,778065127,0,0,0
53498,12616,674926644,674930768,4124,6.11026E-06,0.000611026
54182,26559,1440213657,1439019738,1193919,0.000829675,0.082967521
14622,17601,257361758,257361822,64,2.48677E-07,2.48677E-05
52599,4296,225965780,225965304,476,2.10652E-06,0.000210652
32669,18316,598460444,598365404,95040,0.000158833,0.015883271
20074,32166,643936717,645700284,1763567,0.002731247,0.273124706
10315,19489,201030235,201029035,1200,5.96929E-06,0.000596929
50940,10513,535523004,535532220,9216,1.7209E-05,0.001720905
34414,14444,497180372,497075816,104556,0.000210342,0.021034216
24394,19700,480560760,480561800,1040,2.16413E-06,0.000216413
42417,9473,401492657,401816241,323584,0.000805303,0.080530344
671,26090,18723061,17506390,1216671,0.06949868,6.94986802
19586,27668,543964712,541905448,2059264,0.003800043,0.380004299
24905,12444,309921324,309917820,3504,1.13062E-05,0.001130622
3052,11116,33921916,33926032,4116,0.000121323,0.012132276
57979,11038,639970357,639972202,1845,2.88294E-06,0.000288294
10884,15378,167373003,167374152,1149,6.86486E-06,0.000686486
46508,3484,162050252,162033872,16380,0.00010109,0.010108997
48007,16369,785826583,785826583,0,0,0
50235,22391,1124747457,1124811885,64428,5.72789E-05,0.005727891
33979,3354,113966601,113965566,1035,9.08169E-06,0.000908169
48564,16676,809852032,809853264,1232,1.52126E-06,0.000152126
5938,17384,103226372,103226192,180,1.74374E-06,0.000174374
2706,18653,50363046,50475018,111972,0.002218365,0.221836474
47737,15549,742262613,742262613,0,0,0
55498,11164,619571892,619579672,7780,1.25569E-05,0.00125569
32098,6029,193424694,193518842,94148,0.000486506,0.04865056
4876,25412,123757104,123908912,151808,0.001225158,0.122515804
10982,10995,120741697,120747090,5393,4.46636E-05,0.00446636
26363,11404,300643332,300643652,320,1.06438E-06,0.000106438
20300,6146,124529379,124763800,234421,0.001878918,0.18789184
15938,649,10347926,10343762,4164,0.000402561,0.040256147
14118,14734,208045177,208014612,30565,0.000146937,0.014693679
51165,9572,489609700,489751380,141680,0.00028929,0.028928964
60731,10538,640043753,639983278,60475,9.44947E-05,0.009449466
60521,2855,172788715,172787455,1260,7.2922E-06,0.00072922
15854,17798,282172937,282169492,3445,1.2209E-05,0.001220897
23509,29472,693561072,692857248,703824,0.001015828,0.10158283
46161,10606,489661407,489583566,77841,0.000158994,0.015899431
32332,22990,743058739,743312680,253941,0.000341634,0.034163416
40547,12327,499824057,499822869,1188,2.37684E-06,0.000237684
33718,30930,1044033217,1042897740,1135477,0.001088771,0.108877118
1950,31060,62071256,60567000,1504256,0.024836231,2.483623095
21145,20443,432268883,432267235,1648,3.81246E-06,0.000381246
47726,23077,1100950966,1101372902,421936,0.0003831,0.038310004
40133,5894,236604495,236543902,60593,0.00025616,0.025615964
17565,30471,536946903,535223115,1723788,0.00322069,0.32206905
52117,19629,1023004593,1023004593,0,0,0
62050,9351,580632677,580229550,403127,0.000694772,0.069477158
2847,10766,30658769,30650802,7967,0.000259928,0.025992795
53007,942,49932609,49932594,15,3.00405E-07,3.00405E-05
17715,12253,217061079,217061895,816,3.7593E-06,0.00037593
41996,28023,1176651347,1176853908,202561,0.000172121,0.017212077
10871,5921,64247239,64367191,119952,0.001863558,0.18635581
51,32432,818448,1654032,835584,0.505180069,50.51800691
9090,23128,210717588,210233520,484068,0.002302525,0.230252531
12568,5359,67351895,67351912,17,2.52406E-07,2.52406E-05
23870,14443,344812885,344754410,58475,0.000169613,0.016961349
16741,19154,320657215,320657114,101,3.14978E-07,3.14978E-05
50050,11344,567762080,567767200,5120,9.01778E-06,0.000901778
64222,31566,2027787393,2027231652,555741,0.000274138,0.027413789
544,29165,15329164,15865760,536596,0.033821008,3.382100826
59928,17717,1061744360,1061744376,16,1.50695E-08,1.50695E-06
34392,1048,36041756,36042816,1060,2.94095E-05,0.002940947
23954,447,10735533,10707438,28095,0.002623877,0.262387697
32239,9032,291112948,291182648,69700,0.000239369,0.023936866
24368,19508,475369904,475370944,1040,2.18777E-06,0.000218777
52960,17881,946986268,946977760,8508,8.98437E-06,0.000898437
47814,1166,55747289,55751124,3835,6.87879E-05,0.006878785
10719,10339,110791533,110823741,32208,0.000290624,0.029062365
65467,17447,1142201921,1142202749,828,7.24915E-07,7.24915E-05
63392,18983,1203343311,1203370336,27025,2.24578E-05,0.002245776
30046,26964,808711384,810160344,1448960,0.001788485,0.178848547
26155,26353,688690299,689262715,572416,0.000830476,0.083047579
11025,3581,39476173,39480525,4352,0.000110232,0.011023156
25883,31103,804622501,805038949,416448,0.000517302,0.051730168
59603,2825,168378295,168378475,180,1.06902E-06,0.000106902
39195,15577,610540191,610540515,324,5.30677E-07,5.30677E-05
15947,960,15309120,15309120,0,0,0
29316,11412,334541072,334554192,13120,3.92164E-05,0.003921637
31206,19950,622565289,622559700,5589,8.97745E-06,0.000897745
7779,2428,18982452,18887412,95040,0.005031923,0.503192285
41250,1775,73183661,73218750,35089,0.000479235,0.047923517
34513,18831,649875199,649914303,39104,6.01679E-05,0.006016793
33443,3426,114580089,114575718,4371,3.81494E-05,0.003814944
22247,11741,261208827,261202027,6800,2.60335E-05,0.002603349
44067,31425,1384232035,1384805475,573440,0.000414094,0.041409426
64558,11297,729307326,729311726,4400,6.03309E-06,0.000603309
27090,11659,315845953,315842310,3643,1.15342E-05,0.001153424
41184,1961,80794380,80761824,32556,0.000403111,0.040311125
49745,15938,792856627,792835810,20817,2.62564E-05,0.002625638
13777,13945,192159181,192120265,38916,0.000202561,0.020256062
35264,2795,98561579,98562880,1301,1.31997E-05,0.00131997
24669,30492,750586716,752207148,1620432,0.002154236,0.215423638
17437,12371,215713127,215713127,0,0,0
36907,18210,672033169,672076470,43301,6.44287E-05,0.006442868
17513,2504,43933612,43852552,81060,0.001848467,0.184846711
61478,24519,1507223217,1507379082,155865,0.000103401,0.010340133
37826,12679,479603845,479595854,7991,1.66619E-05,0.001666195
28541,16304,465332464,465332464,0,0,0
64259,1412,90733132,90733708,576,6.34825E-06,0.000634825
46338,7739,358601841,358609782,7941,2.21438E-05,0.002214385
2814,8677,24405254,24417078,11824,0.000484251,0.048425123
12489,31840,398553520,397649760,903760,0.002272754,0.227275379
3308,25027,83036035,82789316,246719,0.002980083,0.29800826
3412,5262,17959339,17953944,5395,0.000300491,0.030049108
3118,24709,76476198,77042662,566464,0.007352602,0.73526016
13607,25226,342773485,343250182,476697,0.001388774,0.138877421
55793,31615,1764142415,1763895695,246720,0.000139872,0.013987222
22308,9151,204283803,204140508,143295,0.000701943,0.0701943
64204,20239,1299424499,1299424756,257,1.9778E-07,1.9778E-05
56696,20472,1160680988,1160680512,476,4.10104E-07,4.10104E-05
49148,13815,678976547,678979620,3073,4.52591E-06,0.000452591
62079,9730,604451453,604028670,422783,0.000699939,0.069993863
13125,19228,252366396,252367500,1104,4.37457E-06,0.000437457
34421,8993,310029157,309548053,481104,0.001554214,0.155421427
8733,28028,244291532,244768524,476992,0.001948747,0.19487473
16955,484,8192060,8206220,14160,0.00172552,0.17255204
5686,14194,80644017,80707084,63067,0.000781431,0.078143078
38184,15930,608281139,608271120,10019,1.64713E-05,0.001647127
24311,1056,25672272,25672416,144,5.60913E-06,0.000560913
42777,5203,222568731,222568731,0,0,0
1802,29475,52945901,53113950,168049,0.003163933,0.316393339
26043,32563,849168705,848038209,1130496,0.001333072,0.133307201
54921,23114,1269900835,1269443994,456841,0.000359875,0.035987488
32073,15748,505071588,505085604,14016,2.77498E-05,0.002774975
25071,23698,594201085,594132558,68527,0.00011534,0.011533958
22700,18569,421423480,421516300,92820,0.000220205,0.022020501
60249,20763,1250948563,1250949987,1424,1.13833E-06,0.000113833
9291,23740,220261140,220568340,307200,0.001392766,0.139276562
34103,21577,735840651,735840431,220,2.98978E-07,2.98978E-05
52833,30977,1635117921,1636607841,1489920,0.000910371,0.091037081
63746,17608,1122439508,1122439568,60,5.3455E-08,5.3455E-06
823,21748,17898604,17898604,0,0,0
54287,15806,858056497,858060322,3825,4.45773E-06,0.000445773
10520,28220,296482972,296874400,391428,0.001318497,0.131849698
25115,6338,159095953,159178870,82917,0.000520905,0.052090456
29017,611,17747899,17729387,18512,0.001044142,0.104414214
44700,29682,1328419587,1326785400,1634187,0.001231689,0.123168901
50496,3119,157495983,157497024,1041,6.60965E-06,0.000660965
34692,11207,388788555,388793244,4689,1.20604E-05,0.001206039
54074,18660,1009080120,1009020840,59280,5.875E-05,0.005875003
30069,23020,691799004,692188380,389376,0.000562529,0.056252895
1059,12668,13413172,13415412,2240,0.000166972,0.016697214
50962,24016,1223823968,1223903392,79424,6.4894E-05,0.006489401
35327,1340,47338180,47338180,0,0,0
34430,20253,697308514,697310790,2276,3.26397E-06,0.000326397
18177,15526,282216115,282216102,13,4.6064E-08,4.6064E-06
33177,3555,117968955,117944235,24720,0.000209591,0.020959057
61743,5953,367507951,367556079,48128,0.000130941,0.013094056
17187,13209,227024903,227023083,1820,8.01681E-06,0.000801681
60545,3624,219382060,219415080,33020,0.000150491,0.015049102
5716,7614,43155051,43521624,366573,0.008422779,0.842277852
27348,24803,678848299,678312444,535855,0.000789983,0.078998256
2550,25662,65556873,65438100,118773,0.001815044,0.181504353
22146,2417,53404882,53526882,122000,0.002279229,0.227922859
59318,27498,1632338045,1631126364,1211681,0.000742849,0.074284925
23038,16913,389640926,389641694,768,1.97104E-06,0.000197104
15268,18090,276291895,276198120,93775,0.000339521,0.033952078
57421,2738,157218775,157218698,77,4.89764E-07,4.89764E-05
20881,22695,474233955,473894295,339660,0.000716742,0.071674212
7080,7042,50210999,49857360,353639,0.007093015,0.709301495
14165,14626,207265775,207177290,88485,0.000427098,0.042709797
61742,29598,1826684145,1827439716,755571,0.000413459,0.041345878
47265,17466,825530395,825530490,95,1.15078E-07,1.15078E-05
4088,19032,77799580,77802816,3236,4.15923E-05,0.004159232
24165,6219,149971863,150282135,310272,0.002064597,0.20645967
57696,8445,487631836,487242720,389116,0.000798608,0.079860814
31096,4386,136389079,136387056,2023,1.48328E-05,0.001483279
38372,12461,478149312,478153492,4180,8.74196E-06,0.000874196
4992,18124,90605756,90475008,130748,0.001445128,0.144512836
5989,30498,180896031,182652522,1756491,0.009616571,0.961657129
62666,7072,443393168,443173952,219216,0.00049465,0.049465001
3893,11508,44800644,44800644,0,0,0
45339,9422,427294677,427184058,110619,0.000258949,0.025894927
61366,21315,1308016033,1308016290,257,1.96481E-07,1.96481E-05
36118,17449,630223050,630222982,68,1.07898E-07,1.07898E-05
56555,8773,496065623,496157015,91392,0.0001842,0.018419975
39250,4952,194364756,194366000,1244,6.4003E-06,0.00064003
51415,6065,311873959,311831975,41984,0.000134637,0.013463661
40882,27703,1133827173,1132554046,1273127,0.00112412,0.112412031
24059,28031,674480069,674397829,82240,0.000121946,0.012194583
11552,28560,329398720,329925120,526400,0.001595514,0.159551355
1996,8431,16611171,16828276,217105,0.012901203,1.290120271
36149,29940,1081432708,1082301060,868352,0.00080232,0.08023202
61561,28501,1752567597,1754550061,1982464,0.001129899,0.11298988
51963,6617,343855871,343839171,16700,4.85692E-05,0.004856922
1766,21414,37816705,37817124,419,1.10796E-05,0.001107964
46405,15308,710367740,710367740,0,0,0
63255,2351,148736057,148712505,23552,0.000158373,0.015837269
54481,29395,1602239043,1601468995,770048,0.000480839,0.048083853
11007,3456,38040384,38040192,192,5.04729E-06,0.000504729
31165,8410,261824223,262097650,273427,0.001043226,0.104322568
52997,6389,338582473,338597833,15360,4.53636E-05,0.004536355
43873,23610,1035444315,1035841530,397215,0.000383471,0.038347082
53509,10972,587100668,587100748,80,1.36263E-07,1.36263E-05
14141,1337,18906761,18906517,244,1.29056E-05,0.00129056
55870,436,24343368,24359320,15952,0.000654862,0.065486229
43765,13730,600896079,600893450,2629,4.37515E-06,0.000437515
23537,4969,116956253,116955353,900,7.69524E-06,0.000769524
20753,18738,388887139,388869714,17425,4.48094E-05,0.004480935
31262,7974,249160425,249283188,122763,0.000492464,0.049246402
13696,23323,319956859,319431808,525051,0.001643703,0.164370293
10009,8598,86154907,86057382,97525,0.001133255,0.113325548
9345,19018,177690571,177723210,32639,0.000183651,0.018365075
3185,21018,66969563,66942330,27233,0.000406813,0.040681285
43541,12717,553705521,553710897,5376,9.70904E-06,0.000970904
38627,13553,523511731,523511731,0,0,0
5494,27954,151640945,153579276,1938331,0.012621045,1.26210453
61645,32696,2016380300,2015544920,835380,0.000414469,0.041446856
27591,6070,167535909,167477370,58539,0.000349534,0.034953379
2521,12631,31842907,31842751,156,4.89907E-06,0.000489907
32392,3480,112747548,112724160,23388,0.00020748,0.020747992
34906,939,32776649,32776734,85,2.5933E-06,0.00025933
55264,27438,1516852495,1516333632,518863,0.000342183,0.034218261
56856,29456,1674352768,1674750336,397568,0.000237389,0.023738941
49770,3025,150553162,150554250,1088,7.22663E-06,0.000722663
13811,15653,216183375,216183583,208,9.62145E-07,9.62145E-05
20350,3517,71537602,71570950,33348,0.000465943,0.046594324
30507,24006,732163777,732351042,187265,0.000255704,0.025570388
17587,19054,335087837,335102698,14861,4.43476E-05,0.00443476
21163,3784,80080452,80080792,340,4.24571E-06,0.000424571
12429,24261,302011009,301539969,471040,0.001562115,0.156211464
12852,19542,251152603,251153784,1181,4.7023E-06,0.00047023
24075,10149,244371143,244337175,33968,0.000139021,0.013902101
17582,22384,393644432,393555488,88944,0.000226001,0.022600117
56353,16696,940869820,940869688,132,1.40296E-07,1.40296E-05
28809,9614,276505031,276969726,464695,0.001677783,0.167778265
30131,1188,35794396,35795628,1232,3.44176E-05,0.003441761
26755,30674,822858745,820682870,2175875,0.002651298,0.265129818
46132,4443,204963639,204964476,837,4.08363E-06,0.000408363
37534,17858,670307097,670282172,24925,3.71858E-05,0.003718583
58996,16065,947770420,947770740,320,3.37634E-07,3.37634E-05
7858,19723,154982305,154983334,1029,6.63942E-06,0.000663942
5824,11878,69159983,69177472,17489,0.000252814,0.025281352
63838,2879,183788321,183789602,1281,6.96993E-06,0.000696993
4838,14980,72470232,72473240,3008,4.1505E-05,0.004150497
51653,14338,740540239,740600714,60475,8.16567E-05,0.008165669
25655,32255,826586825,827502025,915200,0.001105979,0.110597917
65500,22440,1469856636,1469820000,36636,2.49255E-05,0.00249255
23326,21147,493276037,493274922,1115,2.2604E-06,0.00022604
50862,7602,387008601,386652924,355677,0.000919887,0.0919887
